11111111111111
10000000000001
10000000000001
10000002000001
10000001100001
10040000020301
11311140111111
11111111111111

11111111111111
10000000000001
10000000000001
10000000000001
10000030003001
10002020002001
11111010101111
11111111111111

11111111111111
10000000000001
10000000000001
10003400104001
11101112111001
10000003000001
11101112111111
11111111111111

11111111111111
10000000000001
10000000300001
10000000200001
10000000100001
10203000000001
10203000000201
11101000000111
11111011111111
11111111111111

11111111111111
10000000000001
10000000000001
12300330000001
11101111011001
12300000000001
11111001100011
11111101100111
11111111111111